128 0 0 0 0 0 0 0 0 0 0 0
17 17 17 0 17 0 17 17 17 17 0 0
0 0 0 0 17 32 17 0 0 17 0 0
32 0 0 0 17 32 17 0 0 17 0 0
0 0 0 0 17 32 17 0 0 17 0 0
0 0 0 0 17 17 17 0 0 17 0 0
0 0 0 0 0 0 0 0 0 17 0 0
0 16 32 16 0 0 0 0 0 17 0 0
0 16 16 16 0 0 0 0 0 17 0 0
0 0 0 0 0 0 0 0 0 17 0 0
32 17 17 17 17 17 17 17 17 17 32 0
0 0 51 0 0 0 0 0 0 0 0 0
